╔═══════                       
║· · · ■                       
╠·╦═╦═╦═╦═╦═╦═╦═╦═╦═╦═╦═╦═╦═╦═╗
║·║   ║   ║       ║   ║   ║   ║
╠·╬ ╬ ╬ ╬ ╬ ╬ ╬ ╬ ╬ ╬ ╬ ╬ ╬ ╬ ╣
║·║ ║ ║ ║ ║ ║   ║ ║ ║ ║ ║   ║ ║
╠ ╬ ╬ ╬ ╬ ╬ ╬ ╬ ╬ ╬ ╬ ╬ ╬ ╬ ╬ ╣
║   ║ ║ ║ ║ ║   ║ ║ ║ ║   ║   ║
╠ ╬ ╬ ╬ ╬ ╬ ╬ ╬ ╬ ╬ ╬ ╬ ╬ ╬ ╬ ╣
║     ║ ║   ║   ║ ║ ║ ║   ║   ║
╠ ╬ ╬ ╬ ╬ ╬ ╬ ╬ ╬ ╬ ╬ ╬ ╬ ╬ ╬ ╣
║ ║     ║       ║ ║ ║ ║   ║   ║
╠ ╬ ╬ ╬ ╬ ╬═╬═╬ ╬ ╬ ╬ ╬ ╬ ╬ ╬ ╣
║   ║     ║   ║ ║   ║     ║   ║
╠ ╬ ╬ ╬ ╬ ╬ ╬ ╬ ╬ ╬ ╬ ╬ ╬ ╬ ╬ ╣
║· · ·║· ·║ ║ ║· · · · · · ·║ ║
╠ ╬ ╬ ╬ ╬ ╬ ╬ ╬═╬═╬═╬═╬═╬═╬═╬ ╣
║       ║ ║ ║ ║     ║· · ·║·║ ║
╠ ╬ ╬ ╬ ╬ ╬ ╬ ╬ ╬ ╬═╬ ╬ ╬ ╬ ╬ ╣
║         ║ ║ ║   ║ ║· ·║· ·║ ║
╠ ╬ ╬ ╬═╬═╬ ╬ ╬═╬═╬ ╬ ╬ ╬ ╬ ╬ ╣
║ ║   ║   ║ ║ ║   ║  · · · ·║ ║
╠ ╬ ╬ ╬ ╬ ╬ ╬ ╬ ╬ ╬ ╬ ╬ ╬ ╬ ╬ ╣
║ ║ ║ ║ ║ ║ ║ ║      · · · ·║ ║
╠ ╬ ╬ ╬ ╬ ╬ ╬ ╬ ╬ ╬═╬═╬═╬═╬═╬ ╣
║ ║ ║ ║ ║ ║ ║ ║   ║ ║       ║·║
╠ ╬ ╬ ╬ ╬ ╬ ╬ ╬ ╬ ╬ ╬ ╬ ╬ ╬ ╬·╣
║ ║ ║· ·║   ║· ·║   ║       ║·║
╚═╩═╩═╩═╩═╩═╩═╩═╩═╩═╩═╩═╩═╩═╩·╣
                 @ · · · · · ·║
                       ═══════╝